000000000000000000000000
000000000000000000000000
000000000000000000000000
000000000000000000000000
000000000000000000000000
001000000000000000000000
010111111111111111111111
010000000000000000000000
010100000000000000000000
010111110000000000000000
010111111111100000000000
010111111111100000000000
010111111111100001111111
010000000000000000010000
010000000000000000010000
010000000000000000010000
010111100000000000010000
001000111111000000010000
000000111111000000010000
000000111111000000010000
000000100000000000010000
000000100000000000010000
000000100000000000010000
000000111111000000010000
000000111111000000010000
000000111111000000010000
000000111111000000010000
000000111111000000010000
000000100000000000111100
000000100000000000111100
000000100000000000111100
000000100001000000111100
000000100000000000000010
000000100000000000000010
000000111110000111111100
000000000010000100000000
000000000010000100000000
000000000010000100000000
000000000010000100000000
000000000010000100000000